10
sss*******
sbssss****
sssssssss*
*sssssssss
*****sshss
******sss*
**********
**********
**********
**********
**********
